Amino_acid	AminoAcidCode	Codons
Ala	A	GCT,GCC,GCA,GCG
Arg	R	CGT,CGC,CGA,CGG,AGA,AGG
Asn	N	AAT,AAC
Asp	D	GAT,GAC
Cys	C	TGT,TGC
Gln	Q	CAA,CAG
Glu	E	GAA,GAG
Gly	G	GGT,GGC,GGA,GGG
His	H	CAT,CAC
Ile	I	ATT,ATC,ATA
START	START	ATG
Leu	L	TTA,TTG,CTT,CTC,CTA,CTG
Lys	K	AAA,AAG
Met	M	ATG
Phe	F	TTT,TTC
Pro	P	CCT,CCC,CCA,CCG
Ser	S	TCT,TCC,TCA,TCG,AGT,AGC
Thr	T	ACT,ACC,ACA,ACG
Trp	W	TGG
Tyr	Y	TAT,TAC
Val	V	GTT,GTC,GTA,GTG
STOP	STOP	TAA,TGA,TAG

