pop	superpop	genus	dir
bonobo	chimp	pan	../../../../chimp/vcfs/hg19/allelefreq_above0.05/consurf/
ptv	chimp	pan	../../../../chimp/vcfs/hg19/allelefreq_above0.05/consurf/
pte	chimp	pan	../../../../chimp/vcfs/hg19/allelefreq_above0.05/consurf/
pts	chimp	pan	../../../../chimp/vcfs/hg19/allelefreq_above0.05/consurf/
ptt	chimp	pan	../../../../chimp/vcfs/hg19/allelefreq_above0.05/consurf/
FIN	EUR	homo	..
CEU	EUR	homo	..
GBR	EUR	homo	..
TSI	EUR	homo	..
IBS	EUR	homo	..
JPT	EAS	homo	..
KHV	EAS	homo	..
CHB	EAS	homo	..
CHS	EAS	homo	..
CDX	EAS	homo	..
PEL	AMR	homo	..
PUR	AMR	homo	..
CLM	AMR	homo	..
MXL	AMR	homo	..
BEB	SAS	homo	..
ITU	SAS	homo	..
GIH	SAS	homo	..
PJL	SAS	homo	..
STU	SAS	homo	..
ACB	AFR	homo	..
ESN	AFR	homo	..
GWD	AFR	homo	..
MSL	AFR	homo	..
ASW	AFR	homo	..
LWK	AFR	homo	..
YRI	AFR	homo	..
